aba	kapa
abacate	abakati
abacaxi	ananas
abaixar	djungutu
abaixo	bas di
abandonado	bandonadu
abandonar	bandona
abater	bati
abdômen	bariga
abelha	bagera
abençoar	bensua
abertura	abertura
abóbora	bobra
aborrecer	burisi
aborrecido	nervozu
abortar	tira bariga
aborto	bariga sai
aborto	abortu
abraçar	barsa
abrigar	moranta
abrigo	abrigu
abril	abril
abrir	yabri
abscesso	materia
abster	dixa
abundante	abundanti
abundar	abunda
abuso	abuzu
abutre	djugudi
acabado	kabadu
acabamento	kabantada
acabar	kaba
acalmar	kalma
acampamento	kampamentu
acampar	kampa
acariciar	da kariñu
acaso	akazu
aceitação	setason
aceitar	seta
acenar	sana
acender	sindi
acertar	serta
aceso	sindidu
achar	odja
achatar	mopi
acidentar	kauza asidenti
acidente	asidenti
ácido	asidu
acima	riba
acinzentado	sinzentu
aço	asu
acolá	la
acolher	risibi
acolhida	risibidu
acompanhar	kumpaña
aconselhar	konsidja
acordado	kordadu
acordar	korda
acordo	akordu
acostumado	kustumadu
acostumar	kustumanta
acostumar	kustuma
açougue	sugi
açougueiro	bindidur di karni
acreditar	kredita
açúcar	sukru
acumular	djunta kusas
acusar	akuza
adequado	diritu
adequar	djusta
adeus	adeus
adição	adison
adicionar	disiona
adivinhar	dibiña
admirar	dimira
admitir	adimiti
adoçar	dosa
adoecer	duensi
adolescência	badjudesa
adoração	adorason
adorador	adoradur
adorar	adora
adornar	fadja
adquirir	dikiri
adubar	struma
adubo	dubu
adultério	adulteriu
adulto	adultu
advogado	avogado
aeroporto	kampu di aviason
afastar	fasta
afiado	moladu
afiar	mola
afogar	foga
afrouxar	folga
afugentar	fuganta
afundar	funda
agachar	djungutu
agarrar	gara
ágil	rapidu
agilidade	rapides
agir	atua
agitação	muvimentu
agitar	sakudi
agitar	bana
agora	gosi
agosto	agostu
agradável	bon
agradecer	gardisi
agradecimento	gardisimentu
agredir	kai gera
agressão	manera di rimiti kontra
agricultor	labradur
agricultura	agrikultura
agrupado	runidu
agrupar	runi
água	yagu
água de arroz cozido	mambereti
aguçar	pui un kusa fika gudu
agudo	gudu
águia	agia
agulha	gudja
ajoelhar	finka djudju
ajudar	djuda
ajustar	djusta
ajuste	nogosiason
alagar	lagua
alaranjado	larandja
alça	mon
alcançar	yangasa
álcool	alkol
aldeia	aldea
alegrar	kontenta
alegre	kontenti
alegria	alegria
aleijado	alejadu
além	fora
alface	alfas
algodão	algudon
alguém	algin
algum	algun
alho	adju
ali	li
alimentação	alimentason
alimentar	kumenti
alinhar	aliña
aljava	bolsa di bala di flexa
alma	alma
almoço	djanta
alojamento	morada
alojar	nstala
alongamento	alongamentu
alongar	longanta
alteração	mudansa
alterar	altera
alternado	trokadu
alternar	trokia
alto	altu
alto	tchamidu
embriagado	tchamidu
altura	altura
aluno	alunu
alvejar	brankisi
alvo	branku
alvorecer	mansir di sol
amaciar	molisi
armadilha	armadidja
amadurecer	fika maduru
amadurecido	kusidu
amaldiçoar	da praga
amamentar	mamanta
amanhã	amaña
amanhecer	mansi
amante	kaza-dus
amar	ama
amarelado	sta amarelu
amarelecer	pul pa i sta amarelu
amarelo	amarelu
amargar	fika malgos
amargo	malgos
amargura	amargura
amarrado	maradu
amarrar	mara
amarrotar	marlota
amassado	masadu
amassar	masa-masa
ambos	tudu dus
ameaça	amiasa
ameaçar	roka
amendoim	mankara
amiga	amiga
amigo	amigu
amolado	moladu
amolar	mola
amolecer	molisi
amontoar	djunta kusas riba di n'utru
amor	amor
ampliar	amplia
amplo	largu
amuleto	tchifri di iran
anão	anon
ancestral	garandis
anciã	mindjer garandi
ancião	omi garandi
âncora	fundiadera
andaime	ndaimi
andar	yanda
andarilho	yandadur
anel	anel
anexar	djunta
angústia	angustia
angustiado	angustiadu
animal	limaria
anjo	andju
ano	anu
anoitecer	sol na noti
ansioso	turmentadu
ante	anti di
antebraço	brasu di mon
antena	antena
anteontem	unturdia
antepassado	antigus
anterior	antirior
antes	antis
antigamente	antigamenti
antigo	antigu
antílope	gazela
anual	anual
anunciar	anunsia
anunciar uma morte	konta tchur
anúncio	banu
ânus	koba di bunda
anzol	ansol
apagar	paga letra
aparafusar	parafusa
aparecer	parsi
aparição	aparison
apático	disinteresadu
apelidar	da nomi
apelido	manteña
apertado	pertadu
apertar	perta
apertar	kalka boton
apertar	da mon
apicultor	bagereru
apicultura	kriason di bagera
apitar	pita
apito	pitu
aplacar	kalma
aplainar	plania
aplicar	puli
apodrecer	podrisi
apoio	apoiu
apoio para a cabeça	turbuseru
apontar	tchuli
após	dipus
apreender	aprindi
aprender	prindi
apressado	turmentadu
apressar	djanti
aprofundar	bai mas fundu
apropriado	propi
apropriar	toma
apropriar	tudji ku
aproveitar	pirbita
aproximação	pertusi
aproximar	pertusi
aquecer	kenta
aquele	kil
aquém	fora
aqui	li
aquilo	kil
ar	ar
arado	radi
arame	arami
aranha	araña
arar	labra
arbusto	arvuri pikininu
arco	arku
arco-íris	arku di bedja
área rural	tabanka
areia	reia
arenoso	kau ku tene reia manga del
arfar	basa fulgu
argamassa	masa
argila	baru
argumentar	kombersa
argumento	manera di kombersa
aridez	seku
arma	arma
armadilha	armadidja
armadura	armadura
armar	monta
armazém	armasen
armazenagem	manera di rakada
armazenar	rakada
arquear	dobra
arranhão	rañadura
arranjar	randja
arrastar	rasta
arrebatar	rabata
arrebentar	rabenta
arredondar	redonda
arregaçar	ragasa
arreio	kau di sinta na kabalu
arremessar	fertcha
arremetida	rimitidu
arrepiar	rapia
arriar	rianta
arrotar	rota
arroz	arus
arruinado	danadu
arruinar	dana
arrumar	ruma
artéria	arteria
articulação	artikulason
articulação	kontrada di os
árvore	arvuri
as	elis
às vezes	as bes
asa	aza
ascendente	djorson
ascender	sibi
áspero	aspru
assado	yasadu
assaltar	asalta
assalto	asaltu
assar	yasa
assassinar	asasina
assassinato	mortu
assassino	asasinu
assemelhar	parsinti
assento	turpesa
assim	asin
assinalar	sinala
assistência	asistensa
assistir	sisti
assoar	sua
assobiar	subia
assobio	sibiu
assombração	kasisa
assoviar	subia
assustado	pantadu
assustar	panta
atacar	taka
ataque	ataki
atar	mara
até	te
até logo	te logu
atenção	atenson
atender	atindi
atender	kudi telfoni
atender	obi pididu
atendimento	atindimentu
aterrisar	ria
atiçar	tisa
atingir	yangasa
atirar	fugia
atirar	fertcha ku arku
ativo	ativu
atolar	ntola
atoleiro	mantchukut
ator	otor
atrair	atrai
atrapalhar	tarpadja
atrás	tras
atrasar	traza
atraso	trazu
através de	atraves di
atravessar	trabesa
atravessar	fura
atravessar	kamba puntu
atrofiado	manku
atuar	atua
aula	aula
aumentar	omenta
aurora	mandurgada
ausência	falta
avermelhar	burmedja
avestruz	avestrus
avião	avion
avidez	faimadesa
ávido	faimadu
avisar	aviza
aviso	avizu
avó	dona femia
avô	dona matchu
avós	donas di mame
axila	sabaku
azar	mufunesa
azedar	azeda
azedo	azedu
azul	azul
azulado	zuladu
babuíno	santchu
bacia	basia
bagatela	bakatela
bagunceiro	disorganizadu
bainha	baiña
baixo	baxu
balaio	balai
balança	balansu
balanço	balansu
balbuciar	gagisa
balde	baldu
bambu	bambu
banana	banana
bananeira	pe di banana
banco	banku
bandeira	bandera
bandido	bandidu
bando	grupu
banhar	baña
banheiro	kuartiñu
banquinho	bankusiñu
baobá	pe di kabasera
baqueta	po di toka
baralho	baradju
barata	barata
barato	baratu
barba	barba
barbante	barbanti
barbatana	lemi di pis
barbeador	jileti
barbear	barbia
barbeiro	barberu
barco	barku
barra	bara
barraca	baraka
barrar	bara
barriga	bariga
barril	baril
barro	lama
base	bazi
bastante	bastanti
bastão	po
bastar	djusta
bastardo	fidju padidu ku utru mindjer
batalhão	batalion
batata	batata
batata-doce	batata-dos
bate-papo	papia
bater	bati
bater	madja
bater	suta
bater	konki porta
bater	toka tambur
bater palmas	rapika palmu
bater papo	papia
bateria	bataria
baterista	tokadur di bataria
batismo	batismu
bêbado	tchamidur
bebê	bebe
beber	bibi
bebida	bibida
beiço	bis
beijar	beja
beijo	beju
beira	bera
beira-rio	bera di riu
beirada	bera
beliscar	ñopoti
belo	belu
bem	ben
bem-estar	sta ben
bênção	benson
bengala	bingala
beringela	birindjela
besouro	rola-pipa
bexiga	bixiga
bezerra	fidju femia di baka
bezerro	bakasiñu
bicar	tchupiti
bicicleta	biskleta
bico	boka
bifurcação	dibidimentu
bigode	bigodi
bílis	fel
bisavó	turtudona
bisavô	turtudona
bobeira	patarata
bobina	bobina
bobo	tulu
boca	boka
bocado	bokadu
bocejar	yabri boka
bocejo	manera di yabri boka
bochechar	sukuma yagu na boka
bócio	papu garandi
bode	bodi
boi	baka
bola	bola
bolha	bolon
bolsa	barkafon
bolso	bolsu
bom	bon
bomba	bumba
bombolom	bumbulun
bondade	bontadi
bondoso	limpu korson
boné	tchapeu
bonito	bonitu
borboleta	burbuleta
borda	roda
bordado	bordadu
bordar	borda
bordejar	burdia
borracha	buraxa
borrifar	burfa
bosque	matu
bosta	bosta
bota	bota
braço	brasu
branco	branku
brancura	branku fandan
branquear	brankia
brasa	brasa
bravo	brabu
brejo	bulaña
briga	djus
brigar	geria
branquear	brankia
brilhante	brilianti
brilhar	lampra
brilho	briliu
brincadeira	brinkadera
brincalhão	tchalasadur
brincar	brinka
brinco	brinku
brisa	briza
bronze	bronzi
bronzeado	kubridu ku bronzi
bronzear	fasi di bronzi
brotar	nansi
broto	udju
brusco	brutu
bruxa	futsera
bruxaria	futisndadi
búfalo	bufre
bule	buli
bunda	bunda
buraco	buraku
burburinho	n'guni n'guni
burro	buru
busca	buska
buscar	buska
busto	mama
cabana	djemberen
cabana	baraka
cabeça	kabesa
cabeceira	kabesa di kama
cabeleireiro	tisidur di kabelu
cabelo	kabelu
cabelo	kabelu di pintidju
cabelo	kabelu firmi
cabisbaixo	kabesa mpinadu
cabo	kabu
cabra	kabra
cabrito	kabritu
caça	kasa
caça	sukundi-sukundi
caçada	kasa
caçador	montiadur
caçar	montia
cacarejar	kanta kokoroko
cacarejo	kokoroko
cacete	manduku
cachecol	kaskol
cachimbo	kañutu
cachoeira	katarata
cachorrinho	katchuriñu
caco	kaku
cada	kada
cadáver	dufuntu
cadeia	kalabus
cadeira	asentu
cadeira	kareta di duenti
cadela	katchur-femia
caderno	kadernu
café	kafe
café da manhã	matabitchu
cafezal	plantason di kafe
cagar	pupu
câimbra	kaiambra
cair	kai
caixa	kaxa
caixão	kaxon
cal	kal
calar	kala
calça	kalsa
calcanhar	kalkañada
calcinha	kalsiña
caldo	kaldu
calma	kalma
calmaria	kalma
calmo	kalmu
calor	kalur
calúnia	kalunia
caluniar	kalunia
calvície	kareka
cama	kama
camaleão	kamalion
camarão	kamaron
cambalear	singa-singa
cambalhota	kangaluta
câmbio	kambiu
camelo	kamelu
caminhão	kamion
caminhar	yanda
caminho	kamiñu
camisa	kamisa
campainha	kampaiña
campeão	kampion
campo	kampu
campo	kampu
campo	kampu garandi
camponês	labradur
cana	kana
cana-de-açúcar	kana-di-asukar
canal	kanal
canção	muzika
candeeiro	kanderu
caneca	kaneka
canela	kanela
canela	kabaku di po
caneta	kaneta
canhão	kañon
canino	dinti di udju
canivete	kaniveti
cano	tubu
canoa	kanua
cansaço	kansera
cansado	kansadu
cansar	kansa
cansativo	pisadu
cantar	kanta
cântaro	kalma
cântico	kantiku
canto	kantu
canto	kantu
cantor	kantadur
canudo	tubu
cão	katchur
caolho	ñeleli
capacete	kapasiti
capacidade	kapasidadi
capaz	kapas
capim	padja
capinar	kopoti
capturado	prindidu
capturar	prindi
cara	kara
caracol	olonko
caranguejo	karangis
careca	kabesa-seku
carga	karga
carícia	kariñu
carne	karni
carneiro	karnel
caro	karu
caroço	karus
carrapato	karpatu
carregar	karga
carregar	bambu
carregar	karga
carregar	pembi
carregar	karganta
carro	karu
carroça	sareti
carta	karta
cartomante	djambakus
cartucho	kartus
carvão	karbon
carvoaria	furnu di karbon
casa	kasa
casado	kazadu
casamento	kazamentu
casar	kaza
casca	kaska
casca	kabaku di arvuri
cascalho	kaskadju
casco	kaska di tataruga
caso	kazu
caso	na kazu ke
castanha	kastaña
castanheira carité	po di karite
castigar	kastiga
castigo	kastigu
castração	kapa
castrar	kapa
casulo	kaska di burbuleta
catar	kata
catar	kudji
catarro	katar
cativar	nteresa
cativeiro	katiberasku
cativo	katibu
catorze	katorzi
cauda	rabu
caule	tronku
causar	fasi
cavadeira	kobadur
cavaleiro	kabaleru
cavalgar	monta na kabalu
cavalheiro	kavaleru
cavalo	kabalu
cavar	koba
cavilha	po di saporta
cebola	sabola
ceder	da
cedo	sedu
cegar	sega
cego	moku
cegonha	djumi
celeiro	bemba
cem	sen
cemitério	simiteriu
cenoura	sinora
cento e um	sentu i un
cento e vinte	sentu i vinti
cento e vite e um	sentu i vinti i un
centopeia	sen pe
centro	sentru
centro-oeste	sentru oesti
cera	sera
cerâmica	ajuleju
cerca	serka di
cerca	serku
cercado	serkadu
cercar	serka
cereal	garan
cérebro	totona
cerimônia fúnebre	nteru
cerrar	fitcha mon
certeza	sertesa
certo	sertu
cerume	susudadi di oredja
cerveja	serbedja
cessar	kaba
cesta	kufu
céu	seu
chá	xa
chacal	djurtu
chacina	matansa
chaleira	salera
chama	xama
chamada	tchomada
chamar	tchama
chaminé	fumidera
chamuscado	ulilidu
chamuscar	uli
chão	tchon
chapéu	tchepen
chato	lisu
chato	xatu
chave de fenda	tchabi di fenda
chefe	regulu
chefia	xefia
chefiar	xefia
chegada	tchigada
chegar	tchiga
cheia	lagansa
cheio	intchidu
cheirar	tchera
cheiro	tcheru
chicote	tchikoti
chicotear	suta
chifre	tchifri
chifrudo	manga di tchifri
chifrudo	tama kanela
chimpanzé	dari
chinelo	sinelu
chocalhar	balansa
chocalho	rek-rek
choque	xoki
chorar	tchora
choro	tchur
chorume	yagu pretu di lixu
chover	tchuba tchubi
chumbo	tchumbu
chupar	tchupa
churrasqueira	kau di yasa karni
chuva	tchuba
cidade	prasa
cigarro	sigaru
cilada	mboskada
cílio	kabelu di udju
cimento	simentu
cinco	sinku
cinquenta	sinkuenta
cinta	sintu di bariga
cintilar	lampra
cinto	sintu
cintura	sintura
cinza	sinsa
cinza	sinzentu
cinzel	sinzel
círculo	roda
circuncidar	bota fanadu
circuncisão	fanadu
ciscar	garbata
ciúme	siumi
ciumento	kumboseru
clã	djorson
clamar	tchoma
clamor	pididu
claridade	klaresa
claro	klaru
clava	manduku di fidida
clitóris	tchiron
clube	klubu
coabitar	mora na ermondadi
coador	kuadera
coagular	seka
cobertura	tidjadu
cobra	kobra
cobrança	kobransa
cobrar	kobra
cobre	kobri
cobrir	kubri
cocar	tchepen di penas
coçar	kosa
cócegas	tchikini
coceira	kosera
cocho	djemberen di kabalu
coco	kukuneti
coelho	kuidju
cogumelo	guarda-tchuba di sapu
coisa	kusa
cola	kola
colar	kola
colar	konta
colar	kola
colcha	koltcha
colchão	koltchon
colega	mandjua
coletar	kebra
coletar	kudji fruta
colheita	kebur
colheita	tempu di kebur
colher	kudji
colher	kudjer
coleta	kebra
colidir	madja
colina	kau altu
colmeia	kumbu di bagera
colmo	fiu di padja
colocação	puzison
colocar	finkanda
colocar de lado	nkosta
colocar em	pui na
colorido	tindjidu
coluna	kuluna
com	ku
com velocidade e ruído	tchurak
comandar	komanda
comando	kumandu
combinação	kumbinason
combate	luta
combinar	kumbina
começar	kumsa
começo	kumsada
comer	kume
comerciante	bindidur
comerciar	nogosia
comércio	kumersiu
cometer um erro	yara
comida	kumida
comigo	ku mi
como	suma
como	kuma
companheiro	kumpañer
companheirismo	kumpañerasku
comparação	komparason
comparar	kompara
completar	kompleta
completo	kompletu
compor	kumpu
composto	kumpudu
compra	kumpra
comprar	kumpra
compras	kompra
compreender	ntindi
compreensão	ntindimentu
comprido	kumpridu
comprimento	kumprimentu
comprometer	kumprimiti
compromisso	kompromis
computador	komputador
conceber	preña
concha	kombe
concluído	kabadu
concordar	konkorda
condenação	kondenason
condenar	kondena
condolências	manteña di tchur
conduzir	konduzi
conforme	konformu
confuso	kunfundidu
congelado	djeladu
congelar	djela
conhecer	kunsi
conhecido	kunsidu
conhecimento	kunsimentu
conjunto	konjuntu
conosco	ku nos
conquistar	konkista
consciência	konsiensia
conseguir	konsigi
conselho real	konsidju rial
consertar	kumpu
consigo	ku el
construir	kumpu
consumir	konsumi
consumo	konsumu
conta	konta
conta	konta
contaminação	kontaminason
contaminado	kontaminadu
contaminar	kontamina
contar	konta
conter	kibi
conter	tudji
contido	mansu
contigo	ku bo
continuar	kontinua
contínuo	permanenti
conto	storia
contra	kontra
contradição	kontradison
contradizer	purfia
contrair	tursi kurpu
contratar	kontrata
contrato	kontratu
contundir	molostra
contusão	dismintidura
conveniente	ben
conversa	kombersa
conversar	kombersa
convidado	kumbidadu
convidar	kumbida
convite	kumbiti
convosco	ku bos
copiar	kopia
copo	kopu
copular	moka
cópula	markadesa
copular	moka
coqueiro	kukeru
cor	kor
coração	korson
coragem	korajen
corajoso	koradjus
corcunda	kurkunda
corda	korda
cordão umbilical	biku
cordeiro	karnel
coroa	koroa
coroar	pui koroa
corpo	kurpu
corredor	kuridur
córrego	riusiñu
correia	koreia
suspensório	ispensol
correio	koreiu
corrente	korenti
correr	kuri
correto	kuretu
corrida	kurida
corrupto	kuruptu
cortado	kortadu
cortar	korta
cortar	laña
corte	korti
coruja	kikia
corvo	korbu
costa	roda di mar
costas	kosta
costela	os di pontada
costura	kustura
costurar	kusi
cotovelada	kutubelada
cotovelo	kutubel
couro	kuru
couve	kubi
cova	koba
covarde	kobardu
coveiro	supultadur
coxa	perna
coxear	mankusa
coxo	manku
cozido	kusidu
cozinha	kusiña
cozinhar	kusiña
cozinheiro	kusiñeru
crânio	kaku
crescer	kirsi
crescimento	kirsimentu
criança	mininu
criar	kria
crime	krimi
criminoso	kriminus
crise	krizi
crista	krista
crocodilo	djakare
crosta	krosta
cru	kru
crucifixo	santa-krus
cruz	krus
cruzar	kruza
cruzar	kamba
cu	koba di bunda
cueca	trus
cueiros	fralda
cuidado	kuidadi
cuidar	kuida
cuidar	kria baka
cuidar	yama
culpa	kulpa
culpado	kulpadu
culpar	kulpa
cultivar	labra
cultivo	labur
cume	ponta
cumprimentar	fala manteña
cumprimento	manteña
cunhada	kuñada
cunhado	kuñadu
cupim	bagabaga
cura	kura
curado	kuradu
curandeiro	djambakus
curar	kura
curativo	kuratibu
curral	koral
curso	kursu
curtidor	stikadur di kuru
curto	mutchu
curva	kurba
curvar	kurba
curvar	uñi
curvatura	kurvatura
cuspe	kuspiñu
cuspir	kuspi
custar	kusta
custo	kustu
cutelo	tarsadu
dança	badju
dançar	badja
dançar	ronka matchundadi
dançar	badja djambadon
dançarina	badjadur
dançarino	badjadur
dar	da
dar à luz	padi
dar a volta	bolta
dar licença	kolsensa
dar um passeio	pasia
data	data
de	di
debaixo	bas
debulhar	duguña
década	dekada
decidir	disidi
décimo	desimu
décimo nono	desimu nonu
décimo oitavo	desimu oitavu
décimo primeiro	desimu purmeru
décimo quarto	desimu kuartu
décimo quinto	desimu kintu
décimo segundo	desimu sugundu
décimo sétimo	desimu setimu
décimo sexto	desimu sestu
decisão	disizon
declive	riada
decorar	fadja
dedão	dedu garandi
dedo	dedu
defecar	pupu
defender	difindi
defesa	difeza
deficiente	manku
defumado	fumadu
defunto	difuntu
deitado	ditadu
deitar	ditanda
deitar	dita
deixar	disa
deixar	ritira
dela	di sel
delas	di selis
dele	di sel
deles	di selis
delicado	delikadu
demais	dimas
demitir	dimiti
demônio	dimoniu
dente	dinti
dentro	dentru
depenar	pena
depois	dispus
depois de amanhã	dipus di amaña
depositar	dipozita
depósito	dipozitu
depósito	bemba
depósito	tanki di lixu
depressão	fadiga
derramamento	deramamentu
derramar	darma
derramar	darma
derrame	pirdi sangi pa dentru
derreter	ribi
derrubar	durba
desagradável	ka bon
desalojar	muda
desamarrar	dismara
desânimo	dizanimu
desaparecer	disaparsi
desatado	dismaradu
desatar	dismara
descansar	diskansa
descansar a bochecha na mão	pembi kara
descanso	diskansu
descarregar	diskarga
descarregar	rianta
descascar	diskaska
descendente	djorson
descer	disi
descida	riada
descoberto	diskubridu
descobrir	diskubri
desconhecido	diskunsidu
desculpa	diskulpa
desde	des
desdobrar	disdobra
desejar	disdja
desejo	mistida
desembrulhar	disimbuldja
desenhar	dizeña
desenho	dizeñu
desenrolar	disrola
desenterrar	distera
desenterrar	koba
deserto	dizertu
desfazer	disfasi
desgastado	disgastadu
desgastar	disgasta
desgostar	disgosta
desistir	disisti
desligado	disligadu
desligar	disliga
deslizamento	laludura
deslizar	lalu
deslumbrar	mpasma
desmaiar	dismadja
desmentir	disminti
desmentir	disminti
desnudar	dispi
despedida	dispidida
despedir	dispidi
despertador	spertadur
despertar	disperta
despir	dispi
desposar	kaza
desprezar	dispreza
desprezo	disprezu
destelhar	diskubri kasa
destruição	distruison
destruir	distrui
desvanecer	lati
desviar	disvia
desvio	disviu
detalhar	splika tudu
detestar	kiri mal
deus	deus
Deus	Deus
dever	obrigason
dever	dibi
devido a	pabia di
devolver	divulvi
dez	des
dezembro	dizembru
dezena	dizena
dezenove	disanovi
dezesseis	disaseis
dezessete	disaseti
dezoito	disaoitu
dia	dia
diabo	diabu
diamante	diamanti
diarreia	diarea
dicionário	disionariu
diferenciar	diferensa
diferente	diferenti
difícil	difisil
dificuldade	difikuldadi
dificultar	tudji
dificultar	difikulta
dilacerar	pustema
diminuição	diminuson
diminuir	diminui
dinheiro	diñeru
direção	direson
direita	direta
direito	diritu
direito	diretu
direito	bon pekadur
direto	di kumpridu
diretor	diretor
dirigir	diriji
disco	disku
disco	roda di bis
discursar	diskursa
discurso	diskursu
disenteria	diareia
disputa	disputa
disputa	djunda-djunda
disputar	djunda-djunda
distância	distansia
distanciar	lundjusi
distante	distanti
distribuição	manera di raparti
distribuído	rapartidu
distribuir	dibidi
distrito	tabanka
ditado popular	ditu
divagação	pensa tchiu
diversão	diverson
divertido	divirtidu
divertir	dibirti
dívida	dibida
dividido	dibididu
dividir	dibidi
divino	sagradu
divorciado	kin ku kaba kasamenti
divorciar	kaba kasamenti
divórcio	kaba kasamenti
dizer	fala
dizer adeus	dispidi
doação	duason
doar	pati
dobra	dobra
dobrado	dobradu
dobrar	dobra
doce	dos
doença	duensa
doente	duenti
doer	de
doido	dudu
dois	dus
dois mil	dus mil
dolorido	i ta de
domesticar	mansa
doméstico	domestiku
dominar	domina
domingo	dumingu
donzela	badjuda
dor	dur
dormindo	na durmi
dormir	durmi
dote	doti
doze	dozi
duna	montaña di reia
dureza	duresa
durar	dura
duro	duru
dúvida	duvida
duvidar	duvida
duzentos	duzentus
dúzia	duzia
e	ku
ébano	madera pretu
eclipse	eklisi di lua
eclodir	tchentchi
educar	iduka
egoísta	intereseru
eira	terenu
eixo	veiu
ela	el
elas	elis
ele	el
elefante	lifanti
elefantíase	kantimbon
eles	elis
eletricidade	lus
elevação	subida
elevador	elevadur
elevar	sibinti
elevar	sibi
em	na
em cima	riba
em forma de globo	rodondu
em vão	afuan
emagrecer	bida magru
embaçado	fusku
embaixo	bas
embalagem	embalajen
embalar	mbala
embeber	modja
embora	mbora
emborcar	mborka
embriagar	tchami
embrulhar	mbuldja
embrulho	mbuludju
emenda	menda
emendar	ndjudja
empacotar	mbuldja
empatar	mpata
empate	mpati
empilhar	monta
empoeirado	pueradu
empoeirar	puera
empregada	kriada
empregado	kriadu
empregar	mprega
emprestar	pista
empréstimo	imprestimu
empreteado	kemadu
empretear	pretsi
empretecer	pretusi
empurrar	mpura
encantamento	inkantu
encantar	inkanta
encanto	inkantu
encher	intchi
encontrar	nkontra
encontrar	nkontra
encontro	nkontru
encostar	ngosta
encosto	kau di ngosta
encurtar	nkurta
encurvado	nkurbadu
encurvar	nkurba
endereço	indiresu
endireitar	ndirita
endurecer	durisi
enegrecer	pretsi
enfeitar	fadja
enfeite	fadjamentu
enfeitiçar	sagia
enfermaria	infermaria
enfermeira	nfermeru
enferrujado	ferusadu
enferrujar	ferusa
enfiar	fia
enfileirar	formanta
enforcar	nforka
enfraquecer	frakisi
enfurecer	sañanta
enfurecido	ku raiba
enganar	ngana
enganchar	ngata
engano	nganu
engatinhar	ngatiña
engenho	muiñu
engessar	pui jesu
engolir	nguli
engordar	ngorda
engordar	takanta
engordurar	unta
engraçado	ingrasadu
engravidar	preña
enguia	pis kobra
enjaular	prindi
enlouquecer	dudisi
enraivecer	raibanta
enriquecer	rikisi
enriquecimento	rikisimenti
enrolar	dobra
enrubescer	burmedja
enrugado	nornoridu
ensacar	pui na saku
ensinar	sina
ensino	nsinu
ensopado	modjadu
ensopar	solopa
então	enton
enterrado	nteradu
enterrar	ntera
enterro	nteru
entijolar	ruma tidjolu
entorse	dismintidura
entrada	yentrada
entranha	tripa
entrar	yentra
entre	entri
entregar	nterga
entrelaçar	tisi
entristecer	tristisi
enumerar	numera
envelhecer	bedjisi
envelopar	mbuldja
envelope	nvolopi
envenenar	benena
envergonhado	burguñus
envergonhar	burguñanta
enviar	manda
envolver	nvolvi
envolvido	nvolvidu
enxada	intchada
enxadão	intchada garandi
enxame	muntu di bageras
enxergar	odja
enxó	intchon
época	tempu
equilibrar	djustanda
equilíbrio	stabilidadi
errado	yaradu
errar	yara
erro	eru
erva	padja-modjadu
ervilha	ervilia
esbarrar	madja
esbelto	magru
esbranquiçado	brankisidu
escada	skada
escala	skala
escalar	sibi
escalas	midida
escambo	troka
escapar	kapili
escarificação	sarfa
escassear	falta
escassez	falta
escasso	insufisienti
escavação	koba
escavar	koba
escola	skola
escolha	skudju
escolher	kudji
esconder	sukundi
esconderijo	kau di sukundi
escondido	sukundidu
escorpião	lakaran
escorregadio	laludu
escorregão	laludura
escorregar	lalu
escorrer	skuri
escova	skoba
escovar	skoba
escravidão	katiberasku
escravo	skrabu
escrever	skribi
escrita	skrita
escudo	tadjadera
entalhar	dizeña na madera
escurecer	skurisi
escuridão	sukurensa
escuro	sukuru
escutar	sukuta
esfaquear	fakia
esfolar	fola
esforçar	pega tesu
esforço	sforsu
esfregão	fergon
esfregar	ferga
esfriar	frianta
esfumaçar	fumansa
esmagado	potcholidu
esmagar	potcholi
esmeril	pedra di mola
esmola	simola
espada	spada
espada curta	spada kurtu
espalhar	spadja
espancar	suta
espátula	kotineti
espelho	spidju
esperança	speransa
esperar	pera
esperma	kuadju
espesso	gros
espeto	feru
espião	spion
espiar	spia
espiar	paga kulpa
espiga	spiga
espingarda	spingarda
espinha	spiña
espinho	spiñu
espionar	djimpini
espírito	spiritu
espírito bom	alma bon
espírito maligno	alma mau
espirrar	spira
esplêndido	bonitu
esplendor	bonitasku
esposa	mindjer
esposa	dona kasa
esposa	kasa-dus
esposo	spozu
espreguiçar	spindi kurpu
espremer	pirmi
espremido	pirmidu
espuma	sukuma
espumante	sukumanti
espumar	sukuma
esquadro	skladra
esquecer	diskisi
esquecimento	diskisimentu
esqueleto	skeletu
esquentar	kenta
esquerda	skerda
esquerdo	skerdu
esquilo	saniñu
esse	es
estabelecer	stablisi
estabelecido	pudu
estabelecimento	kau
estaca	markason
estação chuvosa	tempu di tchuba
estação fria	tempu di friu
estação quente	tempu di kalur
estação seca	tempu di seku
estacar	marka
estação	tempu
estado	mumentu
estado	stadu
estalar	stala
estanho	stañu
estapear	bofotia
estar	sta
este	e
estender	distindi
esterco	strumu
estéril	sebadu
estéril	tchon seku
esticar	tesanta
estimado	stimadu
estimar	stima
estimular	nkoradja
estômago	stomagu
estourar	rebenta
estrabismo	n'ñeleli
estrada	kamiñu
estrado	kontaplakadu
estragado	stragadu
estragar	dana
estrago	danu
estrangeiro	strandjeru
estrangulamento	forkadura
estrangular	forka
estranho	strañu
estreito	pikininu
estrela	strela
estrume	strumu
estupidez	brutasku
estúpido	stupidu
estuprar	bafa
estupro	bafa
esvaziar	diskolontchi
esverdeado	verdi
esverdear	torna verdi
eu	ami
evacuar	disa
evaporação	bapurason
evaporar	bapura
evitar	nvita
exame	proba
exceder	pasa
excelente	spesial
excisão	fanadu di mindjer
excreção	materia
excremento	koko
excretar	tira
executar	kumpri
executar	mata
exército	izersitu
exibição	aprizentason
exibir	mostra
exorcizar	tira diabu
expansão	spanson
explicação	splikason
explicar	splika
explodir	rebenta
explosão	rebentamentu
exposição	riprizentason
expulsar	serka na
exterior	parti di fora
extinção	sta na kaba
extinguir	kaba
extinto	kabadu
extrair	tira
faca	faka
faca	tarasadu
facada	fakada
facão	tarsadu
face	kara
face	rostu
fácil	fasil
facilitar	fasilita
fadiga	fadiga
faísca	faiska
faiscar	faiska
faixa	bambaran
faixa	faixa
faixa etária	idadi
fala	fala
falar	fala
falcão	falkon
falha	falia
falhar	falia
falsidade	falsidadi
falso	falsu
falta	falta
faltar	falta
fama	fama
família	familia
família	djorson
faminto	faimadu
famoso	famus
famoso	famus
fantasma	fantasma
fardo	pakoti
farejar	tchera
farfalhar	fafadja
farinha	foriña
fase	fazi
fatia	fatia
fatiar	fatia
favo de mel	favu
favor	fabur
favorável	favoravel
favorecer	faburisi
fazenda	ponta
fazer	fasi
fazer	kumpu kufu
fazer alguém se perder	pirdinti
fazer barulho	somna
fazer cócegas	tchikini
fazer fogo	raspa fugu
fazer fogo	fasi fugu
fazer o prato	sirbi kumida
febre	febri
fechado	fitchadu
fechadura	fitchadura
fechar	fitcha
fedor	fedura
fedorento	tchera fedi
feijão	fison
feio	fiu
feitiçaria	futisaria
feiticeiro	futiseru
feitiço	futis
feitiço	yanda muru pa mindjer
feito	kuntisimentu
feixe	fis
fel	fel
felicidade	filisidadi
felicitações	parabens
felicitar	filisita
feliz	felis
fêmea	femia
feminino	femininu
fenda	fenda
feno	fenu
feriado	feriadu
férias	feria
ferida	firida
ferido	fididu
ferimento	firida
ferir	fidi
fermentar	fermenta
fermento	fermentu
ferocidade	brabesa
feroz	feros
ferrão	feron
ferreiro	fereru
ferro	feru
ferrugem	ferus
fervente	ki firbi
ferver	firbi
fervura	ferba
festa	festa
festejar	fasi festa
fetiche	futisaria
feto	sangi
feudo	feudu
fevereiro	febreru
fezes	koko
fiança	fiansa
fiar	fia
fibra	fibra
ficar	fika
ficar adulto	torna garandi
ficar de pé	firma
ficar para trás	fika tras
fígado	figadu
figo	figu
figueira	figera
fila	bixa
filha	fidju-femia
filho	fidju-matchu
filhos	fidjus
filhote	fidju
filtrar	kua
filtro	kuadera
fim	fin
firmeza	firmesa
final	kabantada
finalizar	kabanta
fincar	finka
fingimento	findjimentu
fingir	findji
fino	finu
fio	fiu
firmar	firma
firme	firmi
fiscal	fiskal
fiscalizar	kontrola
fisga	ansol
fisgar	piska
fissura	fenda
fita	fita
fixar	fixa
flatulência	pidi
flauta	flauta
flecha	fretcha
flor	flur
floresta	floresta
fluente	papia ben
fluido	gas
fluir	kuri
flutuação	mau manera
flutuar	boia
fofoca	muntrundadi
fofocar	n'gju-n'gju
fogão	fugon
fogo	fugu
fogueira	fugu
foice	n'oroto
folga	folga
folgado	folgadu
folgar	folga
folha	fodja
folha	padja di palmera
fome	fomi
fonte	fonti
fora	fora
forca	forka
força	forsa
forçar	forsidja
forja	nventa
forjar	forsa
formiga	furminga
formigueiro	firmindjeru
fornalha	furnu
forno	furnu
forquilha	firkidja
forrar	fora
forro	foru
fortalecer	raforsa
forte	forti
fraco	fraku
frágil	fraji
fragilizar	frakisi
fragmento	padas
frango	frangu
franzir	dana rostu
frasco	frasku
frase	frazi
fraudar	kamblatcha
fraude	kamblatchu
freio	travon
frente	dianti
frequentemente	sempri
fresco	fresku
frescor	freskura
frieza	friesa
frigideira	fursidera
frio	friu
fritar	frita
frito	fritadu
fritura	fritu
frondoso	garandi
fronha	froña
fronteira	frontera
frouxidão	lebi
frouxo	yoli
fruta	fruta
fruto	frutu
fuga	fuga
fugir	fusi
fuligem	tisina
fumaça	fumansa
fumar	fuma
fumo	fumu
fundilho	fundiñu
fundir	fundi
fundo	fundu
funeral	nteru
furado	furadu
furador	furadur
furar	fura
furioso	furiozu
furo	buraku
furúnculo	frunku
fuso	fusu
futuro	futuru
gabinete	gabineti
gado	gadu
gafanhoto	gafañoti
gago	gagu
gaguejar	gagisa
gaiola	gaiola
galho	ramu
galinha	galiña
galinha-d'angola	galiña pintadu
galo	galu
galopar	djugta
galope	djugta
gancho	gantchu
garanhão	mansebu
garapa	kalda
garça	garsa
garfo	garfu
gargalhada	gargadjada
gargalhar	gagadja
gargalo	garganti di garafa
garganta	garganti
garoa	yeri-yeri
garra	gara
garrafa	garafa
gás	gas
gastar	gasta
gatinho	gatusiñu
gato	gatu
gavião	mañoti
gazela	gazela
gelo	djelu
gema	djema
gemeção	djimidura
gêmeo	djemiu
gemer	djimi
gemido	djimidu
generosidade	bontadi
generoso	bon
gengibre	djindjimbra
genro	kuñadu
gente	djinti
gentil	galanti
geralmente	normalmenti
gerar	padi
gergelim	djisilin
germe	kuku
germinação	nansi
germinar	soronda
gesso	jesu
gestação	gravides
gestar	konsibi
gigante	djiganti
girafa	jirafa
girar	boltia
girino	fidju di sapu
giz	djis
glande	kabesa de kodjon
glória	gloria
goiaba	goiaba
golpe	golpi
gonorreia	skentamenti
gordo	gurdu
gordura	gurdura
gordura	gurdura
gostar	gosta
gosto	gustu
gostoso	gustus
gostosura	gustundera
gota	pingu
gotejamento	pinga-pinga
gotejar	pinga
governar	guberna
governo	reinansa
governo	gubernu
gozar	torosa
gozar	darma
graça	garasa
grama	grama
grande	garandi
grandeza	garandesa
granizo	tchuba di pedra
granulado	tchokolatisiñu ku ta pudu na bulu
grão	garan
grávida	preña
gravidez	gravides
graxa	graxa
grelha	yasadera
grelhar	grelia
greve	grevi
grilo	grilu
gritar	girta
gritar	pupa
gritaria	gritaria
grito	girtu
grosseria	salbasaria
grosso	gros
grunhido	manera di ronka di limaria
grupo	grupu
guarda-chuva	guarda tchuba
guardar	guarda
guelra	gerla
guerra	gera
guerrear	geria
guerreiro	geriadur
guia	gia
guiar	gia
guindaste	diskargadur
hábil	kapas
habilidade	djitu
habitação	abitason
habitante	abitanti
habitar	abita
hálito	bafu
harmonia	armunia
harmonizar	konserta
harpa	arpa
haste	bara
haver	ten
herança	yardansa
herdar	yarda
herdeiro	arderu
hérnia	erna
hesitar	mbarasa
hiena	lubu
hipopótamo	pis-kabalu
hipótese	ipotizi
história	storia
hoje	aos
homem	omi
homenagem	kumumorason
homônimo	mesmu nomi
homossexual	matchu-mindjer
honesto	seriu
honra	onra
honrado	onradu
honrar	onra
hora	ora
horizontal	orizontal
horta	orta
hospedagem	osprindadi
hospedar	gasidja
hospedeiro	gasidjadur
humor	gozu
humorista	fasidur di torosa
idade	idadi
idiota	tulu
idoso	bedju
igreja	grisia
igual	memu
igualar	djusta
iguana	linguana
ilegal	kontra lei
ilha	djiu
iluminação	lumiason
iluminado	lumiadu
iluminar	lumia
imã	almami
imagem	imajen
imaginação	majinason
imaginar	majina
imaturo	kru
imediatamente	diretamenti
imenso	garandi
imitação	imitason
imitar	kopia
imitar	imita
impedir	tudji
impaciente	ardigadu
impedir	tudji
impetuoso	turmentadu
ímpio	impiu
implorar	pidi
importante	importanti
imposto	mpustu
impotente	ka ta lanta
imprensa	imprensa
imprensar	perta
imundície	susidadi
imundo	susu
incêndio	kemansa
incerto	insertu
inchaço	intchasku
inchar	intcha
incisão	korti
incitar	tchutchi
inclinação	nklinason
inclinado	nklinadu
inclinar	nklina
inclinar	n'uñi
incubar	tchoka
índigo	dongri
infância	mininesa
infecção	infeson
infectar	infeta
inferior	mas pikininu
inferno	nfernu
inflar	intchi
informação	informason
informar	nforma
infração	eru
inhame	ñambi
iniciação	fanadu
início	kumsada
inimigo	inimigu
injeção	ndjeson
injúria	ndjuria
inocência	nosensia
inocente	nosenti
inquieto	bulidur
insanidade	dudesa
insano	dudu
inserção	yentrada
inserir	pui
inseto	insetu
inspeção	inspeson
inspecionar	djubi
inspetor	djubidur
instabilidade	mal situason
instrumentos	kora
insuficiente	insufisienti
insultar	koba mal
insulto	koba mal
inteiro	ntidu
inteligência	djiresa
inteligente	intelijenti
intenção	intenson
intensivo	intensivu
intenso	risu
intenso	forti
interceder	roga
interior	intirior
interrogação	purgunta
interromper	ntrumpi
interrompido	nturumpidu
interrupção	suspenson
intervalo	intervalu
intestino	tripa
intoxicação	tosikason
intoxicar	tosika
inundação	lagansa
inundar	laganta
inútil	ka bali pa uza
invalidez	duensa
inválido	ka bali
inverno	tempu di friu
invocar	nvoka
ir	bai
irmã	ermon-femia
irmão	ermon
irmão	ermonsiñu
irmão	kode
irmão	ermon-garandi
irritado	iritadu
irritar	nerva
isca	iska
já	dja
jacaré	djakare
jamais	nunka mas
janeiro	janeru
janela	djanela
jantar	sia
jardim	djardin
jarra	djaru
jarro	djaru
jaula	gaiola
javali	purku di matu matchu
jejuar	djundjun'a
jejum	djundjun
joelho	djudju
jogar	djuga
jogar fora	bota
jogatina	aposta na djugus
jogo	djugu
jornada	jornada
jovem	djoben
juba	kabelu di kabesa di lion
juiz	djuis
juizado	djuisadu
julgamento	djulgamentu
julgar	djulga
julho	juliu
junção	djunson
junho	juñu
junta	djunta
juntar	djunta
junto	djuntu
juramento	djuramentu
jurar	djurmenta
juros	djurus
justo	djustu
juventude	djubentudi
lá	la
lã	lan
labareda	lingua di fugu
lábio	bis
laço	lastru
laço	no
lacrimejar	lagrimas na ria
lado	ladu
ladrão	ladron
lagarta	bitchu kabelu
lagartixa	lagartisa
lagarto	lagartu
lago	lagua
lagoa	lagua
lagosta	lagosta
lágrima	larma
lama	lama
lamber	limbi
lambida	limbida
lamentação	lamentason
lamentar	miskiña
lâmpada	lampada
lança	kañaku
lançar	lansa
lance	lansi
lanche	lantchi
lápis	lapis
lar	lar
laranja	larandja
lareira	furnu
largo	largu
largura	largura
larva	bitchu
lasca	laska
lascar	laska
latão	lata
latido	ladra
latir	ladra
latrina	kuartiñu
lavagem	labajen
lavar	laba
lavrador	labradur
leão	lion
lebre	lebri
legal	kusa sertu
legal	sta ben
legume	ortalisa
lei	lei
leitão	liton
leite	liti
leito	kama
leitura	leitura
lembrança	lembransa
lembrar	lembra
lenço	lens
lençol	lansol
lenha	leña
lentidão	lentu
lento	lentu
leopardo	liopardu
lepra	lepra
ler	lei
lesma	karakol
leste	saida di sol
letra	letra
levantar	labanta
levantar	lanta
levar	leba
leve	lebi
lhe	u
lhes	elis
libação	da kana pa iran
libélula	manel-fugon
libra	libra
licença	lisensa
líder	lider
liderança	lideransa
ligado	ligadu
ligar	liga
lima	lima
limão	limon
limar	lima
limite	limiti
limonada	sumu di limon
limpar	limpa
limpeza	limpesa
limpo	limpu
língua	lingu
linguagem	lingu
linha	liña
linhagem	djorson
líquido	likidu
liso	lisu
litoral	belamar
livrar	libra di
livro	libru
lixa	lixa
lixar	lixa
lixo	lixu
local	lugar
localizar	lokaliza
lodo	lodu
logo	logu
loja	losa
longe	lundju
longo	kumpridu
lotação	tamañu
lotar	intchi
lote	terenu
louco	luku
loucura	lukisa
louva-a-deus	kriadu di deus
louvar	lova
louvor	luvor
lua	lun'a
luar	lun'ada
lucrar	lukra
lucro	lukru
lugar	lugar
lugar de banho	serku
lugar ritual	baloba
luta	luta
lutar	luta
luto	don
luz	lus
maçã	masan
macaco	santchu
maçaneta	fexu di porta
machadinha	mantchadusiñu
machado	mantchadu
macho	matchu
machucado	matchukadu
machucar	matchuka
macio	moli
maço	masu
madeira	madera
madrugada	mandrugada
madurar	madurisi
maduro	maduru
mãe	mame
mágoa	magua
mago	djambakus
magoado	maguadu
magoar	magua
magreza	magresa
magro	magru
maio	maiu
maior	mas garandi
mais	mas
mal	mal
malária	paludismo
maldade	maundadi
maldição	mufunesa
mal-estar	kasabi
malte	kusa ku ta fasidu kel uiski
malvado	malbadu
mama	mama
mamadeira	mamadera
mamão	papaia
mamar	mama
mamilo	biku di mama
mamona	mamona
mancar	mankusa
manco	manku
mandar embora	serka
mandíbula	dingiñu
mandioca	mandioka
maneira	maña
mangueira	mangera
mangusto	katchur-di-mangu
manhã	maña
manteiga	mantega
manteiga de carité	bambatulu
manter	manti
manto	veu
manto	kapa
manutenção	manutenson
mão	mon
mar	mar
maravilha	inkantu
marca	marka
marcar	marka
marcha	marxa
marchar	marxa
março	marsu
marfim	dinti di lifanti
margem	banda
marido	maridu
marimbondo	bagera-matchu
mariposa	bitchu di lus
marrom	kastañu
martelar	suta ku martel
martelo	martel
mas	ma
máscara	maskara
mascarado	maskaradu
mascarar	maskra
masculino	maskulinu
masculino	matchu
mastigação	mastikason
mastigar	mastika
masturbação	puñeta
masturbar	toka puñeta
matagal	matu garandi
matança	matansa
matar	mata
matéria	materia
mato	matu
mau	mau
mau cheiro	mau tcheru
me	n
mecha	fius
mediar	kumpu kombersa
medicamento	mesiñu
medição	midison
medicar	da mesiñu
medicina	medisina
medicina	djambakusindadi
médico	mediku
medida	midida
médio	mediu
medir	midi
medo	medu
medroso	kobardu
medula	yagu ku ta sta na os
meio	meiu
meio-dia	me-dia
mel	mel
melaço	asukar-ribidu
melancia	melansia
melão	melon
melodia	melodia
membro da vizinhança desprezado	algin ku ka rispitadu na tabanka
membros do conselho	djintis di konsidju
mendigar	pidi simola
mendigo	pididur di simola
menestrel	poeta
menina	minina
menino	mininu
menor	ma pikininu
menos	menus
mensageiro	mensajeru
mensagem	rekadu
mensal	kada mis
menstruação	laba lua
menstruar	odja lua
mentir	foi
mentira	mintida
mentiroso	muntrus
mercado	fera
merda	pupu
mergulhador	murgudjadur
mergulhar	murgudja
mês	mis
mesa	mesa
mesmo	memu
mesquinhez	ruñesa
mesquita	miskita
mestre	mestre
metade	metadi
metal	metal
metálico	metaliku
meteoro	strela ku ta kai di noti
meu	ña
mexer	tchuska
miçanga	konta-delgadu
mico	santchusiñu
micose	mampusma
migalha	padasiñu
migração	migrason
migrar	migra
mijar	minsa
mijo	misadura
mil	mil
mil e cem	mil i sen
mil e cento e um	mil sentu i un
milênio	mileniu
milésimo	milesimu
mil e um	mil i un
mil e vinte	mil i vinti
mil e vinte e um	mil i vinti i un
milhão	milion
milhar	miliaris
milharal	kampada di midju
milho	midju
mim	mi
mimado	mimadu
mimar	mima
mimo	mimu
mineração	kau di koba feru
mingau	papa
minha	di mi
minhas	ña
minhoca	mañoka
minuto	minutu
miolo	miol
vesgo	totoli udju
miserável	koitadi
miséria	mizeria
mistura	djagasi
misturado	misturadu
misturar	djagasi
moça	badjuda
moço	mos
modificar	altera
moela	muela
moer	mui
mogno	bisilon
moinho	muiñu
molar	dinti di pilon
moldar	molga
molde	forma
mole	moli
molhado	modjadu
molhar	modja
molho	mudju
molusco	marisku
monogamia	kasa un
montagem	montajen
montanha	montaña
montão	muntu
montar	monta
monte	monti
moradia	moradia
morador	moradur
morar	mora
morcego	mursegu
morder	murdi
morder	murdi
mordida	murdida
moreno	morenu
morrer	muri
morro	monti
mortalidade	mortundadi
morte	mortu
morto	mortu
mosca	moska
mosquito	miskitu
mostrar	mostra
mostrar os dentes	ñiñi
motocicleta	mota
mover	buli
movimentação	muvimentason
movimento	muvimentu
mucama	kriada
muco nasal	rañu
mucosa	mukoza
muda	fidju di
mudança	troka
mudança	mudansa
mudar	mundanta
mudar	munda
mudo	mudu
muito	manga di
muito	tchiu
muitos	manga di
mulher	mindjer
multa	multa
multar	multa
multicolorido	manga di koris
multidão	manga di djintis
multiplicação	multiplikason
multiplicar	multiplika
mundo	mundu
murchar	murtcha
murcho	nornoridu
murmurar	fasi bokasiñu
muro	muru
músculo	muskulu
música	muzika
músico	muziku
mutilado	mutiladu
na	na
nada	nada
nadador	nadadur
nadar	nada
nádega	bunda
namorada	namorada
namorado	namoradu
namoro	namoru
não	ka
narina	koba di naris
nariz	naris
nascer	nansi
nascer do sol	sol mansi
nascido	padidu
nascimento	nasimentu
natação	nada
nativo	natibu
natureza	naturesa
navalha	lamina
navio	nabiu
neblina	fumansa
necessidade	mistida
necessitar	nesesita
negação	negason
negar	nega
negligente	diskudadu
negócio	nogos
negro	negru
neto	netu
neutro	ka mati
neve	nevi
névoa	fumansa
névoa	fumansa
nevoeiro	fumansa
ninguém	ningin
ninho	niñu
nitidez	klarensa
nítido	klaru
nível	nibel
nivelado	planiadu
nivelar	plania
nó	no
no meio de	na meiu di
noite	noti
noiva	noiba
noivado	noivadu
noivo	noibu
nome	nomi
nomear	pui nomi
nonagésimo	noventa lugar
nono	nonu
nora	neta
nordeste	ladu di saida di sol
norte	norti
nos	nu
nós	anos
nosso	no
notícia	noba
noturno	di noti
novamente	utru bias
nove	nobi
novecentos	novisentu
novembro	novembru
noventa	noventa
novilha	baka femia
novo	nobu
nu	nun
nublado	tindjidu
nublar	tindji
nuca	totis
número	numeru
numeroso	manga del
nunca	nunka
nuvem	nuven
o mesmo	memu
o qual	ku
o que	ke
obedecer	obdisi
obediência	obdiensia
objeto	kusa
obrigação	obrigason
obrigado	obrigadu
obrigar	pui a forsa
observação	observason
observar	djubi
obstáculo	obstakulu
obstinação	risu kabesa
obstinado	ntemus
obstruir	ntupi
obter	konsigi
oceano	osianu
ociosidade	bida susegadu
oco	uku
octogésimo	oitenta lugar
óculos	oklu
odiar	odia
ódio	odiu
odor	tcheru
oeste	ladu di kaida di sol
ofender	ofindi
ofensa	ofensa
oferenda	sakrifis
oferta	oferta
ofertar	pati
ogro	fora nos
oitavo	oitavu
oitenta	oitenta
oito	oitu
oitocentos	oitusentus
oleiro	kumpudur di puti
óleo	oliu
óleo	siti
oleoso	manga di oliu
olhar	djubi
olhar	manera di djubi
olho	udju
ombro	ombra
onda	maron
onde	nunde
ondear	fasi maron
ontem	aonti
onze	onzi
opor	riaji
oposição	opozison
oração	orason
oráculo	djambakus
orar	rasa
ordem	ordi
ordenar	pui na ordi
ordenar	ordena
ordenhar	urdiña
orelha	oredja
órfã	orfan
orfanato	orfanatu
órfão	orfon-matchu
organização	organizason
organizar	organiza
orgulho	orguliu
orgulhoso	orguliozu
orientação	orientason
orientar	orienta
orvalho	urbadju
os	elis
osso	os
ostra	ostra
ou	o
ou seja	ku sedu
ouro	uru
ousado	osanti
ousar	osa
outono	tempu di seku
outro	utru
outubro	otubru
ouvido	oredja
ouvir	obi
ovelha	karnel
ovo	obu
óvulo	obu ku mindjer ta tene
pá	pa
paciência	pasensa
paciente	pasenseru
pacificação	kumpu kombersa
pacificado	kau ku tene pas
pacificar	frianta
pacote	mbuludju
padre	padri
pagamento	pagamentu
pagar	paga
pai	pape
país	tera
pais	padiduris
palácio	palasiu
paladar	gustu
palatável	sabi
palavra	palabra
palha	padja
palma	palmu di mon
palma	fodja di palmera
palma	padja di palmera
palmada	palmada
palmas	palmu
palmeira	palmera
pálpebra	kaxa di udju
palpitação	palpitason
palpitar	palpita
palpite	aposta
pâncreas	pankria
panela	panela
panela	kaselorasiñu
pano	panu
pano	tisidu
pântano	lama
pantera	onsa
panturrilha	butchu di pe
pão	pon
papagaio	papagaiu
papel	papel
papinha	papa
papo	papu
para	pa
para que	afin di
parada	parajen
parafuso	parafusu
parar	para
parcela	kiñon
parecer	parsi
parecer	disizon
parecido	nalidu
parede	paredi
parente	parenti
parentesco	parentasku
parir	padi
parte	parti
parteira	partera
partida	saida
partir	pati
parto	partu
parturiente	bariga-gros
passada	pasu
passado	pasadu
passagem	pasadju
passar	pasa
passarinho	katchu
pássaro	pastru
passear	pasia
passeio	paseiu
passo	pasu
pastagem	kau di bakia
pastar	ferferi
pasto	kau di bakia
pastor	bakiadur
pastor	pastor
pata	pe
pátio	bantaba
pato	patu
pau	po
pausa	intervalu
pausar	para
pavão	pavon
pavor	medu
paz	pas
pé	pe
peça	pesa
pechinchar	lukra tchiu
pedaço	padas
pedido	pididu
pedir	pidi
pedir emprestado	pista
pedra	pedra
pedregoso	ku tene pedra mangadel
pedregulho	kaskadju
pedreiro	pedreru
pegada	pata di pe
pegar	pega
peidar	tira pidi
peido	pidi
peito	pitu
peixe	pis
peixe-gato	bagri
pelado	peladu
pelar	fola
pele	peli
pelicano	pilikana
pelos do corpo	kabelu di kurpu
pelos pubianos	pintiñu
pena	pena
pena	kastigu
pena	pena
penalidade	kastigu
pender	nklina
pendurado	pindradu
pendurar	pindra
peneira	pineria
peneirar	pineria
penetração	moka
penetrar	yentra
penhasco	riba di montaña
penhor	mpiñu
penhorar	piñora
pênis	kodjon
pensamento	pensamentu
pensar	pensa
pente	pinti
pentear	pintia
pentelho	pintiñu
penugem	penasiñu
pepino	pipinu
pequenez	mininesa
pequeno	pikininu
perante	dianti di
perceber	pirsibi
percevejo	dabi
percussão	tambur
perda	perka
perdão	purdon
perdedor	pirdidur
perder	pirdi
perdição	pirdison
perdido	pirdidu
perdiz	tchoka
perdoar	purda
perfeito	pirfitu
perfumado	purfumadu
perfumar	purfuma
perfuração	sondason
perfurar	tchuki
pergunta	purgunta
perguntar	punta
perigo	pirigu
período menstrual	dias di odja lua
periquito	pirikitu
permanecer	fika
permanência	stadia
permissão	pirmison
permitir	pirmiti
perna	perna
perna	pe
pérola	perla
perseguição	pirsigison
perseguir	pirsigi
persuadir	konvensi
persuasão	konvison
pertences	kusas
perto	pertu
perturbar	tarpadja
peru	piru
perversão	manera di nturdja
perverso	malbadu
perverter	nturdja
pervertido	kuruptu
pesado	pisadu
pesar	peza
pescador	piskadur
pescar	piska
pescoço	piskus
peso	pes
pesquisa	piskiza
pesquisar	piskiza
péssimo	ka bali
pessoa	pusua
pessoa idosa	bedju
pessoa importante	pekadur rispitadu
pessoa saudável	pekadur san
pia	pia
piada	piada
piano	pianu
picada	pikada
picada	pikada
pica-pau	katchu-martel
picar	pika
picareta	pikareta
pico	parti gudu di rotcha
piedade	piedadi
pigmeu	pigmeu
pilão	pilon
pilha	pilia
pilhagem	furtu
pimenta	pimenta
pimentão vermelho	sukulbembe
pincel	pinsel
pingar	pinga
pingo	pingu
pintar	pinta
pintinho	pinton
pintura	pintura
piolho	karanga
pipa	baril
piquete	kau di bakia
piroga	kanua
pirraça	temosaria
pisada	pata di pe
pisar	kalka
piscadela	panga udju
piscar	panga udju
piscina	pisina
piso	tchon
pisotear	masa-masa
pista	pista
pistola	pistola
píton	piton
placenta	mparia
planalto	montaña
planejamento	purparason
planejar	purpara
planeta	planeta
planície	kampada
plano	planu
plano	niveladu
planta	planta
plantação	plantason
plantar	paranta
plantio	plantason
plataforma	makina di tira
pó	puera
pobre	pobri
pobremente	di pobri
pobreza	pobresa
poça	koba ku tene yagu
poço	fonti
poder	puder
poder	pudi
poderoso	puderus
podre	podri
podridão	podrisa
poeira	puera
poeirento	pueradu
pois	ampus
polícia	pulisia
poligamia	manga di mindjer
polir	puli
poltrona	banku
polvilhar	tchubiska
pólvora	polbora
pomba	pumba
ponta	ponta
pontapé	pontape
ponte	puntu
pontiagudo	punta gudu
ponto	pontu
pontuar	marka puntu
pontudo	ponta gudu
pôr	pui
por cima	riba di
por que	pabia
porão	puron
porca	porka
porco	purku
pôr do sol	kaida di sol
porque	pabia
porrete	po di madera
porta	porta
portanto	purtantu
portão	porton
posição	pozison
possuidor	dunu
possuir	tene
posto	pustu
postura	atitudi
pote	puti
pote	kaserola
potência	potensia
potencial	putensial
potro	kabalu pikininu
pouco	puku
povo	tribu
pradaria	lala
praga	praga
praguejar	da praga
praia	praia
prancha	prantcha
prantear	tchora
pranto	tchur
prata	prata
prato	pratu
prazer	satisfason
precisar	prisisa
preço	pres
predizer	konta futuru
preencher	prenxi
preenchido	prentchidu
preenchimento	prentchimentu
pregar	perga
prego	pregu
preguiça	pirgisa
preguiçoso	pirgisus
prender	prindi
preparar	purpara
prepúcio	ponta di kodjon
presa	dinti kumpridu
presença	pursensa
presente	presenti
presente	aos un dia
presente	presenti
presentear	da presenti
preservativo	kamisiña
preso	prindidu
pressa	presa
presságio	divinason
pressão	preson
pressionar	kalka
prestar	bali
pretender	pirtindi
pretensão	mistida
preto	pretu
prevenção	prevenson
prevenir	previni
prever	profetisa
prima	prima
primavera	tempu ku arvuris ta soronda
primeiro	purmeru
primo	primu
primogênito	purmeru fidju
princesa	prinsesa
príncipe	prinsipi
prisão	prizon
prisioneiro	prizoneru
problema	prublema
problemático	prublematiku
proclamação	proklamason
proclamar	proklama
procura	prukura
procurador	prokurador
procurar	prukura
produção	pruduson
produzir	pruduzi
produzir	pruduzi
produzir	kumpu
profecia	profesia
professor	pursor
professora	pursora
profeta	prufeta
profetizar	profetisa
profundidade	fundura
profundo	fundu
proibição	mandjidura
proibido	tudjidu
proibir	tudji
prole	familia
promessa	prumesa
prometer	purmiti
pronto	pruntu
pronúncia	purnunsia
pronunciar	purnunsia
propagação	divulgason
propriedade	propriedadi
proprietário	dunu
próprio	propi
prosperar	sedu riku
prosseguir	pursigi
prostituta	djaka
proteção	garda
proteger	prutiji
mancha	mantcha
provação	probason
provérbio	ditu
província	rijon
provisão	rakada
provocação	provokason
provocar	provoka
próximo	pertu
púbis	pintiñu
virilha	koramentu
pudor	borgoña
pular	djuguta
pulga	pulga
pulmão	bof-bof
pulo	pulada
pulsar	bati
pulseira	pulsera
pulso	tchabi di mon
pulverizar	bumba benenu
punhal	puñal
punho	puñu
punição	kastigu
punido	kastigadu
punir	kastiga
pupila	garan di udju
pureza	puresa
purificar	laba
puro	puru
pus	maldadi
puxar	puxa
quadragésimo	korenta lugar
quadril	anka
qual	kal
qualquer	kualker
quando	kal ora
quantos	kantu
quarenta	korenta
quarta-feira	kuarta-fera
quartel	kortel
quarto	kuartu
quarto	kuartu
quatro	kuatru
quatrocentos	kuatrusentus
que	ki
quebrado	kebradu
quebrar	kebra
queda	keda
queijo	keju
queimação	kemansa
queimado	kemadu
queimadura	kemadura
queimar	kema
queixa	kesa
queixar	kesa
queixo	kesada
queixoso	reklamadur
quem	kin
quente	kinti
quentura	kentura
quer dizer	misti fala
querer	misti
quiabo	kandja
quieto	ketu
quietude	kalada
quinhentos	kiñentus
quinquagésimo	sinkuenta lugar
quinta-feira	kinta-fera
quintal	kintal
quinto	kintu
quinze	kinzi
rã	sapu
rachadura	fenda
rachar	ratcha
ráfia	rafia
rainha	raiña
raio	raiu
raiva	raiba
raivoso	raibus
raiz	rais
ralo	koba
ramo	ramu
ranger	ñeme dinti
rangido	madjudura di dinti
rapaz	rapas
rapé	po di tabaku
rapidez	pruntasku
rápido	rapidu
raposa	katchur mangu
rasgado	rumpidu
rasgar	rasga
raso	razu
raspar	rapa
rastejar	rasta
rastrear	sigi
rastro	rastu
ratazana	ratu garandi
rato	ratu
real	rial
realidade	rialidadi
realmente	rialmenti
rebaixar	rianta
rebanho	koral
rebuliço	mburta di konfuson
receber	risibi
recepção	kau di atindimentu
recibo	risibu
recinto	kau
recipiente	panela di lama
recíproco	ku ta sirbi pa dus ladu
reclamação	reklamason
reclamar	raklama
recolher	rukudji
recompensa	rekumpensa
recompensar	rekumpensa
recortado	kortadu
recostar	ngosta
recuperar	rukupera
recusar	rekusa
rede	ridia
rédea	korda di kabalu
redenção	salbason
redimir	salba
redondo	rodondu
redor	na roda di
redução	riduson
reduzir	ruduzi
refazer	fasi di novu
refeição	sia
refrescar	freska
refrigerante	sumu
regatear	punta-punta
região	rijon
regime	rijimi
regozijar	kontenta
regra	regra
régua	regua
rei	rei
reinado	renansa
reiterativo	pa konfirma
rejeição	negason
rejeitar	nega
rejuvenescer	sedu nobu
relação	relason
relacionamento	relasionamentu
relacionar	relasiona
relâmpago	rilampagu
relampejar	lampra
relatório	rilatoriu
relaxamento	relaxamentu
relaxar	diskuda
religião	rilijon
relógio	orlodju
remar	rema
remédio	mesiñu
remela	ramelga
remendar	remenda
remendo	menda
remo	remu
remover	tira
remover	kaba
reparação	riparason
reparar	repara
reparo	riparason
repetição	ripitison
repetir	ripiti
repousar	diskansa
repreender	raprindi
repreensão	raprindison
reputação	fama
resgatar	liberta
resgate	libramentu
residência	kau di mora
residente	abitanti
residir	mora
resmungar	rasmunga
resolver	risolvi
resolver	safa
respeitar	rispita
respeito	rispitu
respiração	manera di da folgu
respirar	da folgu
responder	rispundi
resposta	rasposta
ressaca	korda ku moku
resto	restu
retirar	tira
retirar	ritira
reto	retu
retomar	riba
retornar	riba
reunião	runion
reunir	runi
reverência	venerason
reverso	kontrariu
reverter	muda
revista	revista
reviver	volta vivi
revolta	rabolta
revoltar	rabolta
reza	raza
rezador	rasadur
rezar	rasa
ribeiro	riusiñu
rico	riku
rigoroso	rigurosu
rim	rin
rio	riu
riqueza	rikesa
rir	ri
riso	sorizu
ritmo	ritimu
ritual	sirmonia
rocha	rotcha
roda	roda
rodo	po di djunda yagu
rodovia	kamiñu
roedor	ruidur
roer	rui
roído	ruidu
rolar	rola
rolha	rodja
rolo	rolu
romper	rumpi
rompido	rumpidu
roncar	ronka na sonu
ronco	ronku
ronda	ronda
rosa	roza
rosca	roska
rosnado	ronku
rosnar	ronka
rosto	rostu
rotação	rotason
rotatória	rutunda
roubar	roba
roubo	robu
roupa	ropa
roxo	kor di violeta
rua	rua
ruga	nornori
rugido	manera di rosna di lion
rugir	girta
ruído	ruidu
ruim	ruñu
ruína	kaida
ruindade	ruñesa
ruptura	siparason
sábado	sabadu
sabão	sabon
esperteza	spertasku
sabedoria	sabiduria
saber	kunsimentu
saber	sibi
sábio	sabiu
sabor	sabura
saborear	sinti gustu
saboroso	sabi
sabre	spada suma arku
sabugo	ñaña
sacar	tira
saciado	fartu
saciar	farta
saco	saku
sacrificar	sakrifika
sacrifício	sakrifis
sacudir	sakudi
satisfeito	kontenti
saia	saia
saída	saida
sair	sai
sal	sal
sala	sala
salário	salariu
salgado	salgadu
salgar	salga
saliva	kuspiñu
salpicar	tchubiska
saltar	salta
saltitar	salta-salta
salto	saltu
salvar	salba
sandália	sandalia
sangrar	sangra
sangrar	sangranta
sangue	sangi
sanguessuga	sambasuga
sapatilha	sapatilia di badju
sapato	sapatu
sapo	sapu
saquear	furta
sarna	sarna
satisfação	satisfason
satisfazer	satisfazi
satisfeito	kontenti
saudação	manteña
saudade	sodadi
saudar	fala manteña
saudável	ku saudi
saúde	saudi
savana	lala
se	si
seca	seku
secar	seka
seco	seku
século	sekulu
secura	sekura
seda	seda
sede	sedi
sede	sedi
sedento	ku sedi
seguir	sigi
segunda-feira	sugunda-fera
segundo	sugundu
segurar	sugura
seguro	suguru
seis	seis
seiscentos	seisentus
seiva	liti di po
seixo	kaskadju
sela	sela
selar	sela
seleção	seleson
selecionar	selesiona
seleiro	kusidur
selo	selu
selvagem	salbas
sem	sin
sem graça	ka sabi
semana	sumana
semeadura	simintera
semear	sumia
semelhante	simildjanti
sêmen	kuadju
semente	simenti
sempre	sempri
sênior	garandi
sentado	sintadu
sentar	sintanda
sentar	sinta
sentença	djulgamentu
sentir	sinti
separação	siparason
separado	siparadu
separar	sipara
septuagésimo	setenta lugar
sepultamento	nteru
sepultar	supulta
sepultura	supultura
ser	sedu
ser vivo	bibu
seriedade	seredadi
seringa	siringa
sério	seriu
serpente	kobra
serra	montaña
serra	sera
serrar	sera
serrote	seroti
servir	sirbi
servo	sirbidur
sessão	seson
sessenta	sesenta
sete	seti
setecentos	setisentus
setembro	setembru
setenta	setenta
sétimo	setimu
seu	si
sexta-feira	sesta-fera
sexto	sestu
sicó	siko
sífilis	siflis
significado	signifikadu
significar	signifika
silenciar	kala boka
silêncio	silensiu
silencioso	kaladu
silvo	barudju di kobra
sim	sin
simpatia	simpatia
simpático	simpatiku
sinal	sinal
sino	sinu
sítio	kau
só	so
sob	bas di
sobra	sobra
sobrancelha	sobrinsela
sobrar	sobra
sobre	aserka di
sobremesa	sobramesa
sobressalto	sustu
sobrinho	subriñu
socar	sukia
soco	suku
socorrer	sakura
sofá	sufa
sofrer	sufri
sofrimento	sufrimentu
sogra	dona
sogro	dona
sol	sol
sola	pata di pe
soldado	soldadu
soletrar	seletra
solicitação	pididu
solicitar	solisita
sólido	risu
solo	tchon
solo	tchon
soltar	solta
solteiro	solteru
solto	soltu
soluçar	salusa
soluço	salus
som	son
soma	soma
somar	soma
sombra	sombra
sombreado	ku sombra
somente	somenti
sonhar	suña
sonho	suñu
sono	sonu
sonolento	ku sonu
sopa	sopa
soprar	supra
sopro	supru
sorgo	midju-kabalu
sorrir	ñiñi
sorriso	sorizu
sorte	sorti
sótão	ntudju
sozinho	ami son
sua	si
suado	kaluradu
suar	kalura
suave	suavi
suavidade	manera santadu
suavizar	fasi santadu
sub	sub 
subida	subida
subir	sibi
submeter	rianta kabesa dianti di
subsistência	so pa kume
subtrair	tira
subtrair	roba
suceder	susedi
sucessão	ardansa
suco	sumu
sudeste	sudesti
suficiente	sufisienti
sugar	tchupa
sugerir	propui
sugestão	sujeston
sujar	susa
sujar	ñereti
sujeira	susidadi
sujo	susu
sul	sul
sulco	regu
sulista	moradur di sul
suor	suur
superação	pasanta
superar	ultrapasa
superfície	superfisi
superior	superior
superioridade	vantajen
súplica	pididu
suplicar	roga
suportar	saporta
suporte	suporti
surdo	surdu
surpreender	surprindi
surpreendido	surprendidu
suspender	nturumpi
suspenso	nturumpidu
sussurro	bokasiñu
susto	pantadura
sutiã	kurpiñu
tabaco	tabaku
tabu	malgosadu
tabuada	taguada
tabuleiro	tabuleru
taioba	manfafa
talher	garfu
talvez	talves
tamanduá	tamandua
tamanho	tamañu
tâmara	tambra
tamareira	pe di tambra
tamarindo	tambarina
também	tambi
tambor	tambur
tampa	tampu
tanga	tanga
tanino	taninu
tanto	tantu
tapa	bofotada
tapar	tapa
tapete	tapeti
tarântula	araña
tarde	tardi
tartaruga	tataruga
tataravó	dona femia di bu dona
tataravô	dona matchu di bu dona
tatear	palpa-palpa
tatuagem	tatuajen
tatuar	fasi tatuajen
tchau	tchau
te	u
tear	pinti
tecelagem	kau di tisi
tecelão	tisidur di panu
tecer	tisi
tecido	tisidu
teia	kasa di araña
teimoso	ntemus
tela	ekran
telefonar	telefona
telefone	telefoni
telefonema	telefonema
telha	tidja
telhado	tidjadu
temer	medi
temor	medu
temperar	pui sal
temperatura	tempratura
tempestade	turbada
tempo	tempu
temporada	tempu
tenda	tenda
tendão	nervu
tensão	tenson
tenso	nervus
tentação	tentason
tentar	tenta
ter	tene
terça-feira	tersa-fera
terceiro	terseru
terminado	kabadu
terminar	kaba
terno	fatu
terra	tera
terraço	baranda
terreiro	kintal
terreno	terenu
tesão	lanta
tesoura	tisora
testa	testa
testar	sprimenta
testar	testa
teste	testi
testemunha	tustumuña
testemunhar	tustumuña
testemunho	tustumuñu
testículo	garan di matchundadi
teta	mama
teto	ntudju
teu	di bo
ti	bo
tia	tia
tíbia	tibia
tigela	tijela
tijolo	tidjolu
timidez	burguñu
tímido	burguñantadu
tingir	tindji
tinta	tinta
tintura	tinta pa tindji
tio	tiu
tirar	tira
tiro	tiru
título	titulu
toalha	tuadja di laba kurpu
toca	koba
tocar	toka
tocha	patchu di fugu
toco	mungut
todo	tudu
tolerância	toleransia
tolerar	tulera
tomada	tomada
tomar	toma
tomate	kamati
tombar	bati
tonto	tchan-tchañi
tontura	tuntura
topete	moda di yalsa kabelu dianti riba
topo	riba
toque	toku
toranja	turandja
torção	dismintidura
torcer	tursi
torcicolo	djitu na garganti
torcida	klakerus
torcido	tursidu
tornar	torna
torneira	turnera
tornozeleira	ligadura pa dur di udju di pe
tornozelo	udju di pe
torrado	ulu-ulidu
torrão	tchon risu
torrar	tora
torto	tortu
tosquiar	tiskia
tosse	tusi
tossir	tusi
total	total
touro	turu
tóxico	benenus
trabalhador	tarbadjadur
trabalhar	tarbadja
trabalho	tarbadju
traço	trasu
tradição	tradison
tradicional	tradisional
traidor	traidur
trair	trai
tramar	djanfa
trança	transa
trançado	tisidu
trancar	ntranka
trançar	tisi
tranquilidade	kalma
tranquilo	trankilu
transar	moka
transbordamento	manera di intchi tok i na darma
transbordar	darma
transformação	mudansa
transformar	muda
transpiração	kalur
transpirar	kalura
transplantar	tira orgon dentru di algin pa pui utru
transportar	leba
trapaça	tarpasa
trapacear	tarpasa
trapaceiro	tarpaseru
trapo	ratadju
trás	tras
traseira	tras
traseiro	trasera
trator	trator
travar	trava
trave	viga
travesseiro	turbuseru
trazer	tisi
trecho	spasu
treinamento	trenamentu
treinar	trena
tremer	tirmi
tremida	tirmidura
tremura	manera di tirmi
três	tris
trevas	sukurensa
treze	trezi
trezentos	trizentus
tribo	tribu
tribunal	tribunal
trigésimo	trinta bias
trigo	trigu
trilha	kamiñu pa ka pirdi
trinta	trinta
tripa	tripa
triste	tristi
tristeza	tristesa
troca	troka
trocar	torkia
trombeta	trumbeta
tronco	tronku
tropeçar	da tapada
tropeço	tapada
trovão	turbada
tu	bu
tubarão	tubaron
tubérculo	rais ku ta kumedu
tubo	tubu
tudo	tudu
tumba	tumba
túmulo	tumba
tumulto	tumultu
tumultuar	fasi kunfuson
turbante	kala
úbere	pitu
uivar	pupa
úlcera	ulsera
último	ultimu
ultrapassagem	kambansa
ultrapassar	ultrapasa
um	un
um bilhão	un bilion
um milhão	un milion
um trilhão	un trilion
uma vez	un bias
umbigo	biku di bariga
umedecer	modja
umidade	umidadi
úmido	umidu
unha	n'uña
unhada	finka uña
unhar	ñafini
união	union
único	un son
unir	uni
urina	orina
urinar	xixi
urubu	djugudi
usado	uzadu
usar	uza
usina	fabrika
utensílio	material di tarbadju
útero	madri
útil	util
uva	uva
vaca	baka-femia
vadiar	badia
vadio	badiadur
vagabundo	amonton
vagina	mindjerndadi
vago	ka tene sintidu
vago	sin nada
vaguear	n'ai-n'ai
vala	baleta
valente	balenti
valer a pena	bali pena
vangloriar	karmusa
vapor	fumu
vara	bara
varal	bara di seka
varanda	baranda
varredura	baridura
varrer	bari
vaso	basia
vassoura	basora
vastidão	kau garandi tok i pirdi
vazante	basanti
vazar	darma
vazio	vaziu
veado	frintamba
vegetal	vejetal
veia	veia
velha	bedja
velhice	bedjisa
velho	bedju
velocidade	vulusidadi
veloz	rapidu
veludo	veludu
vencer	ngaña
vendaval	bentu forti
vender	bindi
veneno	benenu
venenoso	benenus
ventania	bentu
ventar	bentu ku na supra
ventilador	bentuiña
ventilar	bentia
vento	bentu
ventre	bariga
Vênus	Venus
ver	odja
verão	tempu di seku
verdade	bardadi
verdadeiro	bardaderu
verde	verdi
verde	verdi
vergonha	burguñu
verme	bitchu
vermelho	burmedju
verruga	bruga
vertical	vertikal
vertigem	tuntura
vesícula	vesikula
vespa	bagera-brabu
véspera	bespra
veste	sabadora
vestido	bistidu
vestimenta	bistimentu
vestir	bisti
vestuário	ropa
véu	veu
vez	bias
viagem	bias
viajante	algin ku sta na bias
viajar	bai bias
víbora	tutu
vibrar	vibra
vice-campeão	sugundu lugar
vida	bida
videira	pe di uva
vidro	bidru
viga	viga
vigésimo	vijesimu
vigésimo primeiro	vinti i un bias
vigia	bisiadur
vigiar	bisia
vila	prasa
vilarejo	prasa
vime	po moli
vingador	tornadur
vingança	bingansa
vingar	binga
vinho	biñu
vinte	binti
vinte e cinco	binti i sinku
vinte e dois	binti i dus
vinte e nove	binti i novi
vinte e oito	binti i oitu
vinte e quatro	binti i kuatru
vinte e seis	binti i seis
vinte e sete	binti i seti
vinte e três	binti i tres
vinte e um	binti i un
viola	biola
violação	violason
violão	violon
vir	bin
virar	mborka
virgem	virjen
vírus	virus
visão	vizon
visgo	biñali
visita	bisita
visitante	bisita
visitar	bisita
vitória	vitoria
viúvo	viuvu
viver	vivi
vivo	bibu
vizinho	viziñu
voar	bua
vocação	dispozison
você	bu
vocês	bo
volante	volanti
volta	bolta
voltar	bolta
vomitar	ramasa
vômito	ramasadura
vontade	bontadi
voo	voo
vos	bos
vós	bo
vosso	bo
voz	vos
vulva	mindjerndadi
xilofone	balafon
zangado	zangadu
zebra	zebra
zelar	zela
zelo	zelu
zelozo	atentu
zerar	paga
zero	zeru